Nigeria,	Africa,
DRC,	Africa,
Egypt,	Africa,
China,	Asia,
Pakistan,	Asia,
India,	Asia,
Turkey,	Asia,
Japan,	Asia,
Russia,	Asia,
Indonesia,	Asia,
South-Korea,	Asia,
Thailand,	Asia,
Vietnam,	Asia,
Iran,	Asia,
England, 	Europe,
United-Kingdom,	Europe,
United-States,	North-America,
Brazil,	South-America,
Mexico,	South-America,
Peru,	South-America,
Singapore,		Asia,

